20, 20, 200, 200, 2, 2, 2x2Tiles.png
-1 0 0 0 0 0 0 0 0 0 0 0 0 0 0 0 0 0 0 0 
3 2 2 2 2 3 1 1 1 1 3 2 2 2 2 3 1 1 1 1 
3 2 2 2 2 3 1 1 1 1 3 2 2 2 2 3 1 1 1 1 
3 2 2 2 2 3 1 1 1 1 3 2 2 2 2 3 1 1 1 1 
3 2 2 2 2 3 1 1 1 1 3 2 2 2 2 3 1 1 1 1 
3 2 2 2 2 3 1 1 1 1 3 2 2 2 2 3 1 1 1 1 
3 2 2 2 2 3 1 1 1 1 3 2 2 2 2 3 1 1 1 1 
3 2 2 2 2 3 1 1 1 1 3 2 2 2 2 3 1 1 1 1 
3 2 2 2 2 3 1 1 1 1 3 2 2 2 2 3 1 1 1 1 
3 3 3 3 3 3 3 3 3 3 3 3 3 3 3 3 3 3 3 3 
0 0 0 0 0 0 0 0 0 0 0 0 0 0 0 0 0 0 0 0 
3 1 1 1 1 3 2 2 2 2 3 1 1 1 1 3 2 2 2 2 
3 1 1 1 1 3 2 2 2 2 3 1 1 1 1 3 2 2 2 2 
3 1 1 1 1 3 2 2 2 2 3 1 1 1 1 3 2 2 2 2 
3 1 1 1 1 3 2 2 2 2 3 1 1 1 1 3 2 2 2 2 
3 1 1 1 1 3 2 2 2 2 3 1 1 1 1 3 2 2 2 2 
3 1 1 1 1 3 2 2 2 2 3 1 1 1 1 3 2 2 2 2 
3 1 1 1 1 3 2 2 2 2 3 1 1 1 1 3 2 2 2 2 
3 1 1 1 1 3 2 2 2 2 3 1 1 1 1 3 2 2 2 2 
3 3 3 3 3 3 3 3 3 3 3 3 3 3 3 3 3 3 3 -2 
